NO textures/wall.xpm 
SO textures/wall.xpm 
WE textures/wall.xpm 
EA textures/wall.xpm

F 55,100,0
C 55,100,0

1111111111 11111111
100000000001
1000001100011
100001 1000001
100001 100001
100000100001
100000000001
100000000001
100000000001
100000000001
100000000001
100000000001
111111111111
