NO ./textures/bark.png
SO ./textures/bark.png                                 

WE ./textures/bark.png
EA ./textures/bark.png

F 55,100,0
C 55,110,0

1111111111 111111111
10000000001 10000001
10000000001 11111111
100S00100001
100000000001
1000001100011
100001 1000001
100001 100001
100000100001
100000000001
100000000001
100000000001
100000000001
100000000001
100000000001
111111111111
