NO ./textures/psg.png
SO ./textures/marseille.png                                 

WE ./textures/lyon.png
EA ./textures/bordeaux.png

F 55,200,0
C 55,0,0

1111111111 111111111
1N000000001 10000001
10000000001 11111111
10000100001
100000000001
1000001100011
100001 1000001
100001 100001
100000100001
100000000001
100000000001
100000000001
100000000001
100000000001
100000000001
111111111111
